10
10
XXXXoXXXXX
XXXXoXXXXX
XXXXoXXXXX
XXXoooXXXX
XXXoXoXXXX
XXXoXoXXXX
XXXoooXXXX
XXXXoXXXXX
XXXXoXXXXX
XXXXNXXXXX
